Map Yay
22
18
0
0
0
0
0
0
0 0 0 7 7 7 7 7 7 7 7 0 0 0 0 0 0 0 0
0 0 0 8 8 8 8 8 8 8 8 0 0 0 0 0 0 0 0
4 0 0 9 9 9 9 9 9 9 9 0 0 0 0 0 0 0 0
0 0 0 9 9 9 9 9 9 9 9 0 0 0 0 0 0 0 0
0 0 0 9 6 6 9 9 9 9 9 0 0 0 0 0 0 0 0
0 0 0 9 8 8 9 9 9 9 9 0 0 0 0 0 0 0 0
0 7 7 6 6 9 9 9 9 9 9 0 0 0 0 0 0 0 0
0 8 8 8 8 9 9 9 9 9 9 0 0 0 0 0 0 0 0
0 9 9 9 9 9 9 9 6 9 9 0 0 0 0 0 0 0 0
1 5 5 5 5 5 5 5 5 5 5 1 0 0 0 0 0 0 0
2 2 2 2 2 2 2 2 3 2 2 2 0 16 16 16 0 0 0
3 3 3 3 3 3 3 3 3 3 3 3 0 0 0 0 0 0 0