#Comment header (length x height)
20
18
0
0
0
0
0
0
0
0
0
0
0 0 0 0 0 0 0 0 19
0 0 0 1 1 1 1 1 1 1 1 0 0 0 1 1 1 1 1 1
0 0 0 2 2 2 2 2 2 2 2 0 0 0 2 2 2 2 2 2
15 15 15 3 3 3 3 3 3 3 3 0 0 0 3 3 3 3 3 3
0 0 0 3 3 3 3 3 3 3 3 0 0 0 3 3 3 3 3 3
1 1 1 3 3 3 3 3 3 3 3 0 0 0 3 3 3 3 3 3
2 2 2 3 3 3 3 3 3 3 3 0 0 0 3 3 3 3 3 3
3 3 3 3 3 3 3 3 3 3 3 0 0 0 3 3 3 3 3 3