Map Yay Yay YAY
21
18
0
0
0
0
0
0
1 1 13
2 2 14 13
3 3 3 14 0 1
3 3 3 3 13 2 0 0 1
3 3 3 3 14 3 0 0 2 1 1
3 3 3 3 3 3 1 0 3 2 2
3 3 3 3 3 3 2 0 3 3 3
3 3 3 3 3 3 3 10 3 3 3 1
3 3 3 3 3 3 3 11 3 3 0
3 3 3 3 3 3 3 12 3 3 1 1 1 1 1 1 1 1 1 1 1
3 3 3 3 3 3 3 3 3 3 2 2 2 2 2 2 2 2 2 2 2
3 3 3 3 3 3 3 3 3 3 3 3 3 3 3 3 3 3 3 3 3