#Comment header (length x height)
20
20
0 0 0 0 0 0 0 0 3 0 0 0 0 0 3 0 0 0 0 0
0 0 0 0 0 0 0 0 3 0 0 0 0 0 3
0 0 0 0 0 0 0 0 3 0 0 0 0 0 3
0 0 0 0 0 0 0 0 3 0 0 0 0 0 3
0 0 0 0 0 0 0 0 3 0 0 0 0 0 3
0 0 0 0 0 0 0 0 3 0 0 0 0 0 3
0 0 0 0 0 0 0 0 3 0 0 0 0 0 3
0 0 0 0 0 0 0 0 0 15 15 15 15 15
0 0 0 19 0 18 0 0 0 0 0 0 0 0 0 0 0 0 17
1 1 1 1 1 1 1 1 1 1 1 1 1 1 1 1 1 1 1 1
2 2 2 2 2 2 2 2 2 2 2 2 2 2 2 2 2 2 2 2
3 3 3 3 3 3 3 3 3 3 3 3 3 3 3 3 3 3 3 3
3 3 3 3 3 3 3 3 3 3 3 3 3 3 3 3 3 3 3 3
3 3 3 3 3 3 3 3 3 3 3 3 3 3 3 3 3 3 3 3
3 3 3 3 3 3 3 3 3 3 3 3 3 3 3 3 3 3 3 3
3 3 3 3 3 3 3 3 3 3 3 3 3 3 3 3 3 3 3 3
3 3 3 3 3 3 3 3 3 3 3 3 3 3 3 3 3 3 3 3
3 3 3 3 3 3 3 3 3 3 3 3 3 3 3 3 3 3 3 3
3 3 3 3 3 3 3 3 3 3 3 3 3 3 3 3 3 3 3 3
3 3 3 3 3 3 3 3 3 3 3 3 3 3 3 3 3 3 3 3