#Comment header (length x height)
20
18
0
0
0
0
0
0
0
0
0 0 0 0 0 0 0 0 0 0 0 0 0 7 7
0 0 0 0 0 0 0 0 0 0 0 0 0 8 8
0 0 0 0 0 0 0 0 0 0 0 0 0 9 9 
0 0 0 0 0 0 0 0 0 0 18 0 0 9 9
0 0 0 0 7 7 7 7 7 7 7 7 0 9 9
0 0 0 0 8 8 8 8 8 8 8 8 0 9 9 0 0 20
1 1 1 1 5 5 5 5 5 5 5 5 1 5 5 1 1 1 1 1
2 2 2 2 2 2 2 2 2 2 2 2 2 2 2 2 2 2 2 2
3 3 3 3 3 3 3 3 3 3 3 3 3 3 3 3 3 3 3 3
3 3 3 3 3 3 3 3 3 3 3 3 3 3 3 3 3 3 3 3