#Comment header (length x height)
24
20
0
0
0
0
0
0
0
0
0
0
0
0
0 0 0 1 0 0 16 16 0 0 0 0 0 0 0 16 16 16 16
0 0 0 2 0 0 0 0 0 0 1
0 0 0 3 0 0 0 0 0 0 2 
1 1 1 3 1 1 1 1 1 1 3 1 1 1 1 1 1 1 1 1 1 1 1 1
2 2 2 3 2 2 2 2 2 2 3 2 2 2 2 2 2 2 2 2 2 2 2 2
3 3 3 3 3 3 3 3 3 3 3 3 3 3 3 3 3 3 3 3 3 3 3 3
3 3 3 3 3 3 3 3 3 3 3 3 3 3 3 3 3 3 3 3 3 3 3 3
3 3 3 3 3 3 3 3 3 3 3 3 3 3 3 3 3 3 3 3 3 3 3 3