#Comment header (length x height)
20
18
0 0 0 0 0 0 0 0 0 0 3
0 0 0 0 0 0 0 0 0 0 3
0 0 0 0 0 0 0 0 0 0 3
0 0 0 0 0 0 0 0 0 0 3
0 0 0 0 0 0 0 0 0 0 3
0 0 0 0 0 0 0 0 0 0 3
0 0 0 0 0 0 0 0 0 0 3
0 0 0 0 0 0 0 0 0 0 3
0 0 0 0 0 0 0 0 0 0 3
0 0 0 0 0 0 0 0 0 0 3
0 0 0 0 0 0 0 0 0 0 3
1 1 1 0 0 0 0 0 0 0 3
2 2 2 0 0 0 0 0 0 0 3
3 3 3 1 1 15 15 15 0 0 3
3 3 3 2 2 0 0 15 15 15 3 0 0 10 1 1 1 1 1 1
3 3 3 3 3 0 0 0 20 0 0 0 10 11 2 2 2 2 2 2
3 3 3 3 3 1 1 1 1 1 1 1 11 12 3 3 3 3 3 3
3 3 3 3 3 2 2 2 2 2 2 2 12 3 3 3 3 3 3 3