Map Yay
12
9
0
0
0
0 0 0 0 0 0 0 0 0 17
0 0 0 0 0 0 0 15 15 15 15
0
21 0 0 0 0 0 0 0 0 0 19 0 20
1 1 1 1 13 0 0 10 1 1 1 1 1 1
2 2 2 2 14 1 1 11 2 2 2 2 2 2