#Comment header (length x height)
20
18
0 0 0 0 0 0 0 0 0 0 0 0 0 0 0 0 0 3 0 0
0 0 0 0 0 0 0 0 0 0 0 0 0 0 0 0 0 3 0 0
0 0 0 0 0 0 0 0 0 0 0 0 0 0 0 0 0 3 0 0
0 0 0 0 0 0 0 0 0 0 0 0 0 0 0 0 0 3 0 0
0 0 0 0 0 0 0 0 0 0 0 0 0 0 0 0 0 3 0 0
0 0 0 0 0 0 0 0 0 0 0 0 0 0 0 0 0 3 0 0
0 0 0 0 0 0 0 0 0 0 0 0 0 0 0 0 0 3 0 0
0 0 0 0 0 0 0 0 0 0 0 0 0 0 0 0 0 3 0 0
0 0 0 0 0 0 0 0 0 0 0 0 0 0 0 0 0 3 0 0
0 0 0 0 0 0 0 0 0 0 0 0 0 0 0 0 0 3 0 0
0 0 0 0 0 0 0 0 0 0 0 0 0 0 0 0 0 3 0 0
0 0 21 0 0 0 0 0 0 0 0 0 0 17 0 0 0 3 0 0
1 1 1 1 1 13 0 0 0 0 0 16 16 16 16 15 15 3 0 0
2 2 2 2 2 14 13 0 0 0 0 0 0 0 0 0 0 0 15 15
3 3 3 3 3 3 14 13
3 3 3 3 3 3 3 14 1 1 1 1 1 1 1 1 1 1 1 1
3 3 3 3 3 3 3 3 3 2 2 2 2 2 2 2 2 2 2 2
3 3 3 3 3 3 3 3 3 3 3 3 3 3 3 3 3 3 3 3