Map Yay
20
18
0 0 0 0 0 0 0 0 0 0 0 0 0 0 0 0 1 0 0 0
0 0 0 0 0 0 0 0 0 0 0 0 0 0 16 0 2 0 0 0
0 0 0 0 0 0 0 0 0 0 0 0 0 0 16 17 3 0 0 0
0 0 0 0 0 0 0 0 0 0 0 0 0 0 16 3 0 0 0 0
0 0 0 0 0 0 0 0 0 0 0 0 0 0 16 0 0 0 0 0
0 0 0 0 0 0 0 0 0 0 0 0 0 0 16 0 0 0 0 0
0 0 0 0 0 0 0 0 0 0 0 0 0 0 16 16 0 0 0 0
0 0 0 0 0 0 0 0 0 0 0 0 0 0 16 0 0 0 0 0
0 0 0 0 0 0 0 0 0 0 0 0 0 0 16 0 0 0 0 0
0 0 0 0 0 0 0 0 0 0 0 0 0 0 16 16 0 0 0 0
0 0 0 0 0 0 0 0 0 0 0 0 0 0 16 0 0 0 0 0
0 0 0 0 0 0 0 0 0 0 0 0 0 0 16 0 0 0 0 0
0 0 0 0 0 0 0 0 0 0 0 15 15 15 16 16 16 0 0 0
0 0 0 0 0 0 0 0 0 0 0 0 0 0 0 0 0 16 0 0
0 0 0 0 0 7 7 0 0 0 18 0 0 0 0 19 0 0 0 20
13 21 0 0 0 8 8 0 10 1 1 1 1 1 1 1 1 1 1 1 1
14 1 1 1 1 5 5 1 11 2 2 2 2 2 2 2 2 2 2 2 2
3 2 2 2 2 2 2 2 12 3 3 3 3 3 3 3 3 3 3 3 3